bet	bet	bet
swear	swore	sworn
bid	bid	bid
throw	threw	thrown
broadcast	broadcast	broadcast
wear	wore	worn
hit	hit	hit
withdraw	withdrew	withdrawn
hurt	hurt	hurt
beat	beat	beaten
let	let	let
bite	bit	bitten
put	put	put
choose	chose	chosen
quit	quit	quit
drive	drove	driven
set	set	set
eat	ate	eaten
shut	shut	shut
fall	fell	fallen
spread	spread	spread
forbid	forbade	forbidden
upset	upset	upset
forget	forgot	forgotten
have	had	had
forgive	forgave	forgiven
make	made	made
freeze	froze	frozen
hear	heard	heard
get	got	gotten
lay	laid	laid
give	gave	given
pay	paid	paid
hide	hid	hidden
say	said	said
ride	rode	ridden
sell	sold	sold
rise	rose	risen
tell	told	told
shake	shook	shaken
bend	bent	bent
speak	spoke	spoken
build	built	built
steal	stole	stolen
creep	crept	crept
take	took	taken
deal	dealt	dealt
wake	woke	woken
dream	dreamed	dreamt
write	wrote	written
feel	felt	felt
bleed	bled	bled
keep	kept	kept
breed	bred	bred
leave	left	left
feed	fed	fed
lend	lent	lent
flee	fled	fled
lose	lost	lost
hold	held	held
mean	meant	meant
lead	led	led
send	sent	sent
speed	sped	sped
sleep	slept	slept
cling	clung	clung
spend	spent	spent
dig	dug	dug
sweep	swept	swept
drink	drank	drunk
bring	brought	brought
hang	hung	hung
buy	bought	bought
ring	rang	rung
catch	caught	caught
run	ran	run
fight	fought	fought
shrink	shrank	shrunk
seek	sought	sought
sing	sang	sung
teach	taught	taught
sink	sank	sunk
think	thought	thought
stick	stuck	stuck
blow	blew	blown
strike	struck	struck
do	did	done
swim	swam	swum
draw	drew	drawn
swing	swung	swung
go	went	gone
win	won	won
grow	grew	grown
light	lit	lit
know	knew	known
shoot	shot	shot
lie	lay	lain
sit	sat	sat
see	saw	seen
slide	slid	slid
shine	shined	shone
spit	spat	spat